01111110
1P0000E1
100C0001
100C0001
01111110
