11111111111111111111
10000000000c00100101
10111111111100100001
1p000000000000100101
11111011111000100001
100000000000cc000011
10111110111001c000c1
10000000000001000001
10000001000001000001
100000010111100001c1
10000000010e11000101
10000001010011000001
10000001010011100001
100000010000100cc001
11111111111111111111