11111111
1p0000e1
100c0001
11111111