11111111111111111111111111111111111111111
1P0000C0000000000000000000000000000000001
10000000000000000C000000000000000C0000001
10000000000000000000000000000000000000001
10101010101010101010101010000C00001111111
10000000000000000000001011000000000000111
100000000000C0000000001010000000000000011
100000000000C0000000001010CCCCCCCCCCCC011
100000000000C0000000001010C0C0C0C0C0C0011
100000000000C00000000010100C0C0C0C0C0C011
10000000000000000000001E11111111111111111
11111111111111111111111111111111111111111
