11111111111111111111
1C000000000C00100101
10111111111100100001
1P000000000000100101
11111011111000100001
100000000000CC000011
10111110111001C000C1
10C00000000001000001
10000001000001000001
100000010111100001C1
10000000010E11000101
10C00001010011000001
100C0001010011100001
1C0000C10000100CC001
11111111111111111111