11111111
100C0001
1P0000E1
11111111