1111111111
1P0000C0E1
100C0CC001
100C0CC001
100C0CC001
100C0CC001
100C0CC001
100C0CC001
100C0CC001
100C0CC001
100C0CC001
100C0CC001
100C0CC001
100C0CC001
100C0CC001
100C0CC001
100C0CC001
100C0CC001
100C0CC001
100C0CC001
100C0CC001
100C0CC001
100C0CC001
100C0CC001
100C0CC001
1000000001
100C0CC001
1111111111