11111111111111111111
1C000000000C00000001
1000000000000000C001
1P000000000000000001
10000000000000000001
100000000000CC000001
10000000000000C000C1
10C0000C00E000000001
10000000000000000001
100000000000000000C1
10000000000000000001
10C00000000000000001
100C0000000000000001
1C0000C00000000CC001
11111111111111111111