11111111
10C00111
1P0001E1
11111111