11111111111111111111111111111111
10000000000CCCCCCCCC000CCC000001
10000000000CCCCCCCCC000CCC0000E1
10000000000CCCCCCCCC000CCC000001
10000000000CCCCCCCCC000CCC000001
1P000000000CCCCCCCCC000CCC000001
11111111111111111111111111111111